###
#@######
#      #
#      #
# .  $ #
#      #
#      #
########